border_size=1
usage=map

Xu, Xu, Xu, Xu, Xu, Xu, Xu, Xu, Xu, Xu, Xu, Xu, Xu, Xu, Xu, Co, Co, Co, Co, Co, Co, Co, Co, Co, Xu, Cud, Cud, Cud, Cud, Cud, Cud, Cud, Cud, Cud, Cud, Cud, Gg, Xu, Gg, Gg, Gg, Gg, Gg, Gg, Gg, Gg
Xu, Ww, Uu, Uu, Uu, Uh, Uh, Uu, Uu, Ww, Uh, Uu, Uh, Xu, Xu, Co, Co, Co, Co, 9 Kud, Co, Co, Co, Co, Xu, Cud, Cud, Cud, Cud, Cud, Cud, Cud, Cud, Cud, Cud, Cud, Gg^Efm, Gg, Gg^Efm, Gs^Fp, Gg, Gs^Fp, Gs^Fp, Gg, Gg, Gg
Xu, Uu, Xu, Xu, Ww, Xu, Xu, Xu, Xu, Uh, Xu, Xu, Xu, Ko, Xu, Co, Co, Co, Co, Co, Co, Co, Co, Co, Xu, Cud, Cud, Cud, Cud, Cud, Cud, Cud, Cud, Cud, Cud, Cud, Xu, Xu, Xu, Gg, Gg, Gg, Gs^Fp, Gg, Gg, Gg
Xu, Xu, Xu, Xu, Xu, Xu, Xu, Xu, Xu, Xu, Xu, Xu, Xu, Xu, Xu, Co, Co, Co, Co, Co, Co, Co, Co, Co, Xu, Xu, Xu, Xu, Xu, Xu, Xu, Xu, Xu, Xu, Xu, Xu, Xu, Uu, Xu, Gg, Gg, Gg, Gg, Gg, Gg, Gg
Cud, 7 Kud, Cud, Cud, Cud, Xu, Rd, Rd, Rd, Rd, Rd, Rd, Rd, Rd, Xu, Co, Xu, Co, Rr, Rr, Rr, Co, Xu, Co, Xu, Rd, Rd, Rd, Rd, Xu, Rd, Rd, Cud, Cud, Cud, 8 Kud, Xu, Uu, Xu, Gg, Gs^Fp, Gg, Gs^Fp, Gg, Gg, Gg
Cud, Cud, Cud, Cud, Cud, Xu, Rd, Xu, Xu, Xu, Xu, Xu, Xu, Rd, Rd, Xu, Rd, Xu, Rr, Cud, Rr, Xu, Rd, Xu, Rd, Rd, Rd, Rd, Rd, Xu, Rd, Rd, Rd, Cud, Cud, Cud, Xu, Uu, Xu, Gg, Gs^Fp, Gg, Gs^Fp, Gs^Fp, Gg, Gg
Cud, Cud, Cud, Cud, Cud, Xu, Rd, Xu, Rd, Rd, Rd, Rd, Rd, Rd, Rd, Rd, Rd, Xu, Rr, Rr, Rr, Xu, Rd, Rd, Rd, Rd, Rd, Rd, Rd, Xu, Rd, Rd, Rd, Cud, Rd, Cud, Xu, Uu, Xu, Gg, Gg, Gs^Fp, Gs^Fp, Gs^Fp, Gg, Gg
Cud, Cud, Cud, Cud, Cud, Xu, Rd, Xu, Xu, Rd, Xu, Rd, Xu, Rd, Xu, Rd, Xu, Xu, Rr, Rr, Rr, Xu, Rd, Rd, Rd, Rd, Rd, Rd, Rd, Xu, Rd, Rd, Rd, Rd, Rd, Rd, Xu, Uh, Xu, Gg, Gg, Gs^Fp, Gs^Fp, Gg, Gg, Gg
Cud, Cud, Cud, Cud, Cud, Xu, Rd, Xu, Rd, Xu, Rd, Xu, Rd, Xu, Rd, Xu, Rd, Xu, Rr, Rr, Rr, Xu, Rd, Rd, Rd, Rd, Rd, Rd, Rd, Cud, Rd, Rd, Rd, Rd, Rd, Rd, Xu, Uu, Xu, Gg, Gs^Fp, Gs^Fp, Gs^Fp, Gg, Gg, Gg
Xu, Cud, Xu, Xu, Xu, Xu, Xu, Rd, Xu, Rd, Xu, Rd, Xu, Rd, Xu, Rd, Xu, Cud, Rr, Rr, Rr, Cud, Rd, Rd, Rd, Rd, Rd, Rd, Rd, Xu, Rd, Rd, Rd, Rd, Rd, Rd, Xu, Uu, Xu, Gg, Gs^Fp, Gs^Fp, Gs^Fp, Gs^Fp, Gg, Gg
Cud, Cud, Cud, Cud, Cud, Xu, Rd, Xu, Rd, Xu, Rd, Xu, Rd, Xu, Rd, Xu, Rd, Xu, Rr, Rr, Rr, Xu, Xu, Rd, Xu, Rd, Xu, Rd, Xu, Xu, Xu, Rd, Xu, Rd, Cud, Rd, Xu, Uh, Xu, Gg, Gs^Fp, Gs^Fp, Gs^Fp, Gs^Fp, Gg, Gg
Cud, Cud, Cud, Cud, Cud, Xu, Rd, Rd, Rd, Rd, Rd, Rd, Rd, Rd, Rd, Rd, Rd, Xu, Rr, Rr, Rr, Xu, Rd, Xu, Rd, Xu, Rd, Xu, Rd, Xu, Rd, Xu, Rd, Xu, Rd, Xu, Xu, Uu, Xu, Gg, Gg, Gs^Fp, Gs^Fp, Gs^Fp, Gg, Gg
Cud, Cud, Cud, Cud, Cud, Rd, Rd, Rd, Rd, Rd, Rd, Rd, Rd, Rd, Rd, Rd, Rd, Xu, Rr, Rr, Rr, Xu, Rd, Rd, Rd, Rd, Rd, Xu, Rd, Rd, Rd, Rd, Rd, Rd, Rd, Rd, Xu, Uu, Xu, Gg, Gs^Fp, Gg, Gg, Gg, Gg, Gg
Xu, Cud, Xu, Xu, Xu, Xu, Rd, Rd, Rd, Ww, Ww, Ww, Ww, Ww, Rd, Rd, Rd, Cud, Rr, Rr, Rr, Cud, Rd, Rd, Rd, Rd, Rd, Rd, Rd, Rd, Rd, Rd, Rd, Rd, Rd, Rd, Xu, Uu, Uu, Xu, Gs^Fp, Gs^Fp, Gs^Fp, Gg, Gg, Gg
Cud, Cud, Cud, Cud, Cud, Xu, Rd, Rd, Rd, Ww, Wo, Wo, Wo, Ww, Rd, Rd, Rd, Xu, Rr, Rr, Rr, Xu, Rd, Rd, Rd, Rd, Rd, Xu, Rd, Rd, Rd, Rd, Rd, Rd, Rd, Rd, Xu, Uh, Uu, Xu, Gs^Fp, Gs^Fp, Gs^Fp, Gg, Gg, Gg
Cud, Cud, Cud, Cud, Cud, Rd, Rd, Rd, Rd, Ww, Ww, Wo, Ww, Ww, Rd, Rd, Rd, Xu, Rr, Rr, Rr, Xu, Xu, Rd, Xu, Rd, Xu, Xu, Rd, Rd, Rd, Rd, Rd, Rd, Rd, Rd, Xu, Uu^Uf, Uu, Xu, Gs^Fp, Gs^Fp, Gg, Gg, Gg, Gg
Cud, Cud, Cud, Cud, Cud, Xu, Rd, Rd, Rd, Ww, Rd, Ww, Rd, Ww, Rd, Rd, Rd, Xu, Rr, Rr, Rr, Xu, Rd, Xu, Rd, Xu, Rd, Xu, Rd, Rd, Rd, Rd, Rd, Rd, Rd, Rd, Xu, Uu, Uh, Xu, Gs^Fp, Gs^Fp, Gg, Gg, Gs^Fp, Gs^Fp
Xu, Cud, Xu, Xu, Xu, Xu, Rd, Rd, Rd, Rd, Rd, Rd, Rd, Rd, Rd, Rd, Rd, Cud, Rr, Rr, Rr, Xu, Rd, Rd, Rd, Rd, Rd, Xu, Rd, Rd, Rd, Rd, Rd, Rd, Rd, Rd, Xu, Uu, Uh, Xu, Gg, Gg, Gs^Fp, Gs^Fp, Hh^Fms, Gs^Fp
Cud, Cud, Cud, Cud, Cud, Xu, Rd, Rd, Rd, Rd, Rd, Rd, Rd, Rd, Rd, Rd, Rd, Xu, Rr, Rr, Rr, Xu, Rd, Rd, Rd, Rd, Rd, Rd, Rd, Rd, Rd, Rd, Rd, Rd, Rd, Rd, Rd, Xu, Uu, Xu, Gg, Gg, Gs^Fp, Gs^Fp, Gs^Fp, Hh^Fms
Cud, Cud, Cud, Cud, Cud, Xu, Xu, Xu, Xu, Xu, Xu, Xu, Xu, Xu, Xu, Xu, Xu, Xu, Rr, Rr, Rr, Cud, Rd, Rd, Rd, Rd, Rd, Xu, Rd, Rd, Rd, Rd, Rd, Rd, Rd, Rd, Rd, Xu, Uu, Xu, Xu, Gg, Gg, Gs^Fp, Gs^Fp, Hh^Fds
Cud, Cud, Cud, Cud, Cud, Cud, Rd, Rd, Rd, Rd, Rd, Rd, Rd, Xu, Rd, Rd, Rd, Xu, Rr, Rr, Rr, Xu, Xu, Rd, Xu, Rd, Xu, Xu, Xu, Rd, Xu, Rd, Xu, Rd, Xu, Rd, Xu, Xu, Xu, Uu, Xu, Gs^Fp, Gg, Gg, Gs^Fp, Gs^Fp
Xu, Xu, Xu, Xu, Xu, Xu, Xu, Xu, Xu, Rd, Rd, Rd, Rd, Xu, Rd, Rd, Rd, Cud, Rr, Rr, Rr, Xu, Rd, Xu, Rd, Xu, Ke, Xu, Rd, Xu, Rd, Xu, Rd, Xu, Rd, Xu, Cud, Xu, Xu, Uu, Xu, Gg, Gg, Gs^Fp, Gs^Fp, Gs^Fp
Cud, Cud, Cud, Cud, 2 Cud, Cud, Cud, Cud, Cud, Xu, Rd, Rd, Rd, Xu, Rd, Rd, Rd, Xu, Rr, Rr, Rr, Xu, Rd, Rd, Rd, Rd, Rd, Xu, Rd, Rd, Rd, Rd, Rd, Rd, Cud, Cud, Cud, 6 Kud, Xu, Uh, Uh, Xu, Xu, Gs^Fp, Gs^Fp, Gs^Fp
Cud, Cud, Cud, 1 Cud, Cud, 3 Cud, Cud, Cud, Cud, Xu, Rd, Rd, Rd, Xu, Rd, Rd, Rd, Xu, Rr, Rr, Rr, Cud, Rd, Rd, Rd, Rd, Rd, Xu, Rd, Rd, Rd, Rd, Rd, Rd, Cud, Cud, Cud, Cud, Rd, Xu, Xu, Uu, Xu, Gg, Gg, Gs^Fp
Cud, Cud, Cud, 4 Cud, Cud, 5 Cud, Cud, Cud, Cud, Xu, Rd, Rd, Rd, Rd, Rd, Rd, Rd, Xu, Rr, Rr, Rr, Xu, Rd, Rd, Rd, Rd, Rd, Xu, Rd, Rd, Rd, Rd, Rd, Rd, Rd, Cud, Cud, Cud, Rd, Rd, Xu, Uu, Xu, Gg, Gg, Gg
Xu, Cud, Cud, Cud, Cud, Cud, Cud, Cud, Xu, Xu, Rd, Rd, Rd, Rd, Rd, Rd, Rd, Xu, Rr, Rr, Rr, Xu, Xu, Rd, Rd, Rd, Rd, Xu, Rd, Rd, Rd, Rd, Rd, Rd, Rd, Rd, Rd, Rd, Rd, Rd, Rd, Xu, Xu, Xu, Gg, Gg
Xu, Xu, Xu, Cud, Cud, Cud, Xu, Xu, Xu, Xu, Xu, Xu, Xu, Xu, Xu, Xu, Xu, Xu, Rr, Rr, Rr, Xu, Xu, Xu, Xu, Xu, Xu, Xu, Xu, Rd, Rd, Rd, Xu, Rd, Xu, Rd, Rd, Rd, Rd, Rd, Xu, Xu, Xu, Xu, Gs^Fp, Gg
Xu, Xu, Xu, Cud, Cud, Cud, Xu, Xu, Xu, Xu, Xu, Xu, Xu, Xu, Xu, Xu, Xu, Xu, Cud, Rr, Cud, Xu, Xu, Xu, Xu, Xu, Xu, Xu, Xu, Rd, Cud, Rd, Xu, Xu, Xu, Rd, Cud, Rd, Xu, Xu, Xu, Xu, Xu, Xu, Gs^Fp, Gs^Fp
Gg, Xu, Gg, Xu, Rd, Xu, Gg, Xu, Gg, Xu, Gg, Xu, Xu, Xu, Gg, Xu, Gg, Xu, Gg, Cud, Gg, Xu, Gg, Xu, Gg, Xu, Gg, Xu, Gg, Xu, Rd, Xu, Gg, Xu, Gg, Xu, Gg, Xu, Gg, Xu, Gg, Xu, Xu, Xu, Gs^Fp, Gs^Fp
Gg, Gg, Gg, Gg, Rd, Gg, Gg, Gg, Gg, Gg, Gg, Gg, Gg, Gg, Gg, Gg, Gg, Gg, Gg, Rd, Rd, Gg, Rd, Gg, Rd, Gg, Rd, Gg, Rd, Rd, Rd, Gg, Rd, Gg, Rd, Rd, Rd, Gg, Rd, Gg, Rd, Gg, Rd, Gs^Fp, Rd, Rd
Gg, Gg, Gg, Gg, Rd, Gg^Efm, Rd, Rd, Rd, Gg, Rd, Rd, Rd, Rd, Rd, Rd, Rd, Rd, Rd, Rd, Gg, Rd, Gg, Rd, Gg, Rd, Gg, Rd, Gs^Fp, Gs^Fp, Gs^Fp, Rd, Gg, Rd, Gg, Rd, Gg, Rd, Gg, Rd, Gg, Rd, Gg, Rd, Ha, Gg
Gg, Gg, Gg, Gg, Rd, Rd, Gg, Gg, Gg, Rd, Gg, Gg, Gg, Gg, Gg, Gg, Gg, Gg, Gg, Gg, Gg, Gg, Gg, Gg, Gg, Gg, Gg, Gs^Fp, Hh^Fp, Hh^Fp, Hh^Fp, Gs^Fp, Gg, Gg, Gg, Gg, Gg, Gg, Gg, Gg, Ha, Gg, Gg, Gg, Ha, Ha
Gg, Gg, Rd, Rd, Gg^Efm, Gg, Gg, Gg, Gg, Gg, Gs^Fp, Gg, Gs^Fp, Gs^Fp, Gs^Fp, Gg, Hh, Hh, Hh^Fp, Gg, Gg, Gg, Gg, Gg, Gg, Gg, Gg, Gs^Fp, Hh^Fp, Hh^Fp, Hh^Fp, Gg, Gg, Gg, Gg, Gg, Gg, Gg, Gg, Gg, Ha, Ha, Ha, Ha, Ms, Ms
Gg, Gg, Rd, Gg, Gg, Gg, Gg, Gg, Gs^Fp, Gs^Fp, Gs^Fp, Gs^Fp, Gg, Gg, Gs^Fp, Gs^Fp, Hh^Fp, Hh^Fp, Hh^Fp, Gs^Fp, Gs^Fp, Gg, Hh, Gg, Gg, Gg, Hh^Fp, Hh^Fp, Hh^Fp, Hh, Hh^Fp, Hh, Hh^Fp, Gg, Gg, Gg, Gg, Gg, Gg, Gg, Ha, Ha, Ms, Ms, Ke, Ms
Gg, Rd, Gg, Gg, Gg, Gg, Gg, Gs^Fp, Gs^Fp, Gs^Fp, Gg, Gs^Fp, Gg, Gg, Gg, Hh^Fp, Hh^Fp, Hh^Fp, Hh^Fp, Gs^Fp, Gs^Fp, Hh^Fp, Hh^Fp, Hh^Fp, Gg, Hh^Fp, Hh^Fp, Hh, Hh^Fp, Hh^Fp, Hh^Fp, Hh^Fp, Hh^Fp, Hh^Fp, Gg, Gg, Ha, Ha, Ha, Ha, Ms, Ms, Ms, Ms, Ms, Ms
